XXXXXXXXXXXXXXXXXXXXXXXXXXXXX
X          X                X
X XXXXXXXXXX XXXXXXXXXXXXXX X
X          X X              X
XXXXXXXXX XX X XXXXXXXXXXXXXX
X          X X               
XXXXXXXXXX X XXXXXXXXXXXXXXXX
X           S               X
XXXXXXXXXXXX XXXXXXXXXXXXXXXX
X            X              X
X XXXXXXXXXX XXXXXXXXXXXXXX X
X          X         X      X
XXXXXXXXXX X XXXXXXXXXXXXXX X
X          X                X
XXXXXXXXXXXXXXXXXXXXXXXXXXXXX
