XXXXXXXXXXXXXXXXXXXXXXXXXXXXXXXXXXXXXX
XX                                  XX
XX XXXXXXXXXXXXXXXX  XXXXXXXXX     XXX
XX XXXXXXXXXXXXXXXXX XXXXXXXXXXXX XXXX
XX XX XXXXXXXXXXXXXX XXXXXXXXXXX  XXXX
X                                   XX
X XXXXXX XXXXXXXXXXX XXXXXXXXXXXXXX XX
X XXXXXX XXXXXXXXX   XXXXXXXXXXXXXX  X
X       S          X                 X
XX XXXX  XXXXXXXXXXX XXXXXXXXXXXXX    
XX XXXXX XXXXXXXXXXX XXXXXXXXXXXXX XXX
XX                                 XXX
XX XXXXXXXXXXXXXXXXXXXXXXXXXXXXXXX XXX
XX                                  XX
XXXXXXXXXXXXXXXXXXXXXXXXXXXXXXXXXXXXXX
