XXXXXXXXXXXXXXXXXXXXXXXXXXXXXXXXXXXXXXXX
X X X   X      X                       X
X X       XXXX X XXXXXXXXXXXXX  XXXXXX X
X XXXXXXX X  XXX   X                 X X
X X            X XXXXXXXXXXXXXXXXXXXXX X
X XXXXXXXXXXXX X X                     X
X        X     X XXXXXXX XXXXXXXXXX XX X
XXX XXXXXXXXXX X XX        X X       X X
  X             S  X     X X X    X    X
X XXXXXXXXXXX X XXXXXXXXXX X XXXXXX XX X
X X           X  X                  X  X
X X XXXXXXXX XXXXXXXXXXXXX XXXXXXXXXXXXX
X X      X   X                         X
X XXXXXXXXXXXXXXXXXXXXXXXXXXXX XXXXXXX X
X         X      X                   X X
XXXXX XX XXXXXXX XXXXXXXXXXXXXXXXXXX X X
X      X       X             X        XX
X XXXXXXXXXXX XXXXXXXXXXXXXXXXXXXXXXX XX
X                                     XX
XXXXXXXXXXXXXXXXXXXXXXXXXXXXXXXXXXXXXXXX
