XXXXXXXXXXXXXXXXXXXXXXXXXXXXXXXXXXXXXXXX
X      X                               X
XX XXX XX XXXXXXXXXXXXXXXXXXXXX XXXXXX X
X  X       X                           X
X XXXXXXXX XXXX XXXXXXXXXXXXXXXXXXXXXX X
     X     X    X                    X X
X X XXXXXXXXXXXXXXXXXXXXXXXXXX XXXXXXX X
XXX XXXXXXXXXX                 X     X X
X   X         XXXXXXXXX XXXXXXXXXXXX X X
X XXXXXX XXXXX X                       X
X X            XXXXXXXXXXXXX XXXXXXXXXXX
X XXXXXXXXXXXX                X        X
X X  X  X    XXXXX XXXXXXXXXXXXXXXXXXX X
X X X X   X      X                     X
X X X XXXX  XXXXXXXXXXXXXXXXXXXXXXXXXX X
X X       S                            X
X X XXXXXX XXXXXXXXXXXXXXXXXXXXXXXXXXXXX
X X XX  XX                             X
X X     X XXXXXXXXXXXXXXXXXXXXXXXXXXXX X
X XXXXXXXX XXXX                      X X
X X       X    X                     X X
X XXXXXXXXXXXX XXXXXXXXXXXXXXXXXXXXXXX X
X                                      X
XXXXXXXXXXXXXXXXXXXXXXXXXXXXXXXXXXXXXXXX
