XXXXXXXXXXXXXXXXXXXXXXXXXXXXXXXXXXXXXXXXX
X                                    XXXX
  XX XXXXXXXXXXXXXXXXXXXXXXXXXXXXXXX XXXX
XXXX                                 XXXX
XXXX  XXXXXXXXXXXXXXXXXXXXXXXXXXXXX  XXXX
XXXX  X                           X  XXXX
XXXX     XXXXXXXXXXXXXXXXXXXXXXX  X  XXXX
XXXX  X  X                     X  X  XXXX
XXXX  X  X  XXXXXXXXXXXXXXXXX  X  X  XXXX
XXXX  X  XXXX      X           X  X  XXXX
XXXX  X  X  X  XXXXXXXXXXX  X  X  X  XXXX
XXXX  X  X  X  X         X  X  X  X  XXXX
XXXX  X  X  X  XXXXX XX  X  X  XXXX  XXXX
XXXX  X  X  X     X   X  X  X  X  X  XXXX
XXXX  X  X  X  X  X S X  X  X  X  X  XXXX
XXXXXXX  X  X  X  X   X  X  X  X  X  XXXX
XXXX  X  X  X  X  XXXXX  X  X     X  XXXX
XXXX  X  X  X  X            X  X  X  XXXX
XXXX     X  X  XXXXXXXXXXXXXX  X  X  XXXX
XXXX  X  X  X               X  X  X  XXXX
XXXX  X  XXXXXXXXXXXXXXXXX  X  X  X  XXXX
XXXX  X  X                     X  X  XXXX
XXXX  X  XXXXXXXXXXXXXXXXXXXXXXX  X  XXXX
XXXX  X    X                      X  XXXX
XXXX XXXXXXXXXXXXXXXXXXXX  XXXXXXXX  XXXX
XXXX                                 XXXX
XXXX XXXXXXXXXXXXXXXXXXXXXXXXXXXXXXX XXXX
XXXX                                 XXXX
XXXXXXXXXXXXXXXXXXXXXXXXXXXXXXXXXXXXXXXXX